Row,Column1,Column2,Column3,Column4,Column5,Column6,Column7,Column8,Column9,Column10
1,1,0,3,0,5,0,1,0,3,0
2,0,1,0,3,0,5,0,1,0,3
3,1,0,3,0,5,0,1,0,3,0
4,0,1,0,3,0,5,0,1,0,3
5,1,0,3,0,5,0,1,0,3,0
6,0,1,0,3,0,5,0,1,0,3
7,1,0,3,0,5,0,1,0,3,0
8,0,1,0,3,0,5,0,1,0,3
9,1,0,3,0,5,0,1,0,3,0
10,0,1,0,3,0,5,0,1,0,3
11,1,0,3,0,5,0,1,0,3,0
12,0,1,0,3,0,5,0,1,0,3