Row,Column1,Column2,Column3,Column4,Column5,Column6,Column7,Column8,Column9,Column10
1,1,1,1,1,1,3,3,3,3,3
2,3,3,3,3,3,5,5,5,5,5
3,1,1,1,1,1,3,3,3,3,3
4,3,3,3,3,3,5,5,5,5,5
5,1,1,1,1,1,3,3,3,3,3
6,3,3,3,3,3,5,5,5,5,5
7,1,1,1,1,1,3,3,3,3,3