Row,Column1,Column2,Column3,Column4,Column5,Column6,Column7,Column8,Column9,Column10
1,1,0,3,5,5,5,5,0,1,0
2,0,3,0,5,0,0,0,3,0,3
3,5,0,1,3,3,3,3,3,5,0
4,0,1,0,3,1,1,1,1,0,0
5,3,0,5,1,1,0,5,0,1,0
6,0,5,0,1,0,0,0,5,0,3
7,1,0,3,0,0,0,1,0,3,0
8,0,3,0,5,0,0,0,5,0,5
9,5,0,1,0,0,0,1,0,3,0
10,0,1,0,3,0,0,0,3,0,1