Row,Column1,Column2,Column3,Column4,Column5,Column6,Column7,Column8,Column9,Column10
1,1,0,0,0,5,5,0,0,0,3
2,0,1,0,0,5,5,0,0,3,0
3,0,0,1,0,5,5,0,3,0,0
4,0,0,0,1,5,5,3,0,0,0
5,5,5,5,5,1,3,5,5,5,5
6,0,0,0,0,3,1,0,0,0,0
7,0,0,0,3,5,5,1,0,0,0
8,0,0,3,0,5,5,0,1,0,0
9,0,3,0,0,5,5,0,0,1,0